sublime-text|Sublime Text
visual-studio-code|Visual Studio Code
iterm2|iTerm 
hammerspoon|Hammerspoon
surge|Surge
wechat|WeChat
telegram|Telegram
feishu|Feishu
intellij-idea|IntelliJ IDEA
pycharm-ce|PyCharm CE
kap|Kap
appcleaner|AppCleaner
keycastr|KeyCastr
the-unarchiver|The Unarchiver
bartender|Bartender 5
vlc|VLC
omnidisksweeper|OmniDiskSweeper
qqmusic|QQMusic
bitwarden|Bitwarden
android-platform-tools
bruno|Bruno
zspace|ZSpace
shottr|Shottr
raycast|Raycast
craft|Craft
google-chrome|Google Chrome
microsoft-edge|Microsoft Edge
microsoft-excel|Microsoft Excel 
microsoft-word|Microsoft Word
microsoft-powerpoint|Microsoft PowerPoint
microsoft-outlook|Microsoft Outlook
baiduinput
drawio|draw.io
font-hack-nerd-font
font-fira-code-nerd-font
font-jetbrains-mono-nerd-font
